  
73 6
84 146
83 3
84 145
55 3
67 151
100 0
0 143
74 14
24 148
117 5
85 153
117 0
118 144
79 14
19 154
60 2
17 142
60 2
49 152
90 127
11 67
22 31
94 77
72 145
9 99
84 37
4 94
1110110111111111100111111111101011001111111111111011201222010220220011012021111202122222202120201121202222202211021010111111111110111111111a01011110111011111111
1110111111101011101110111011111111111111111011111110110011011202212121101222121120110212202222222120012222201110121111011111111100111111111a00111111101010111111
0111111101111111110111111111011100101101101111111011111110211012121022212121012021112020202022202222200222212210220111101111111111111111011a11101111111110111111
1111111111111111010010111111011111101111111011011011121111222122212112022022022022222012221200222212222220222201111101110111111110101011111a11111001011101001011
1110100101001111110111010111101111010101111011111111012221011222022122022112212122122222111012222222222220022220221111111111110110011111111a01111111111111110110
1011111100001110111010111111111111111111111111111101221221102021112012122222101222222220222221220212022222220221101111110101011011101111111a11111111111110111111
1101111011101011111111101111111111111111111111111110212122100122212221101000120120221122012210112222122222122122111110111110111111110111111a11011010011110011111
0111111110101111122101110012111020220121012202111011002112211112221212112022002222212102212221202221222222222122211111111111111111101101000a11111111110111011011
1100111111111111020221221220111120012221011121111001020211010100102102011211202222120001221202202112122220222222001111111111001110111101111a11111010111111110111
1111011011110111102210002110101201201112201201111011110210122210112122101221120222210202122222220222222112102022021111111110111111011111000a11110111111111111111
111111101101011110110120022222221221010aaabbaaaaaaaaaababbabbbbbabbaaaaabbaababbabbabbabbbbbbbabbbbb222212122002121111111111111111111111110a01110001111101111111
011111111111110122021201210011112112101b20111111110022120112222012110221120120122222120122122201122b212222212212221111011011011110101101111a11111111110111111111
111111110111111001122211021200220112211a12221210101111212202221122200222202200222211220222122221220b120020222211120111111011011011111010111a10111111111111100111
101011101111111120122222020012001002201b11222001110120222012201222110210011212020221101220222102120b022220011222021111101101011110101111111a01101111011010111011
110011111110111112021011122110122221121a12212211111111220021212112212212212102012000202222220222011b121212222221211111111111111110111011110a11111011111011111111
111110111111011122212110212211022021210b11022011110121221111210111220211101111222221022222202122220b122220222111021111111111111101111111011a01011111101111010111
110111110111110102210121022022222212221b22011201011112111022211000110122201122202122222112202220212b212220222212121101111101111111010111011a11111111110111111111
111111101111110120012221122100211101110a10212111111002022211202122220210202022022121202022220220211b222020221210011011111111110100111111111a11110011111101111111
010011111011110011221212212220111022002b21021111111012120211110021210122122221222212112222212221122a222222210012220111111011011111001111110a11100101111111111011
111101111111100100011210021220101111102b12201200110112212201121122112122211101021210222121012221211a121202122110211110101100111110010110111a11111001101011111101
111101111111111121222101011021111211012a21221011111000211101001121222111222121100011020121211221022b121100122022221101111111111111110111111a11101101011111111011
111111111111111121120121101211121212222a22112011111111222121121202021012211021010111112210221022211b202020222210101111110110111111101111100a11111111111101111011
111110111111111121011020222122222002111b22122211110121112022001122220001112110022001002122221220020a000211022102000111101111111011111111101a11011110111110101101
111111101111111122121122021212201122222b01111011111120101111222210222112202211121211210222022202111b212122211010121011111101111111110001010a11111111011011001111
111010010110111121110112101021012121100a10210210111112020102111212122211121112211101111111110100111a001101111100100111111011101111111111011a11101111111011111111
111111001111101111111111111111002211201a12121211011121222121021201022121111210110110111011111011111a111111111111111110111010110110010111011a01111101111011010111
111011100111101111220100102010121122212a12002011111110111111111110111111101111111111111111111001110a111111111111111010100101011111111111111a11101111111111101111
111111110111111111201221221122100201021b22101211111111111111011110111101111111110011111011111110111a101101111101101101101111111101110110111a01001011011011111111
111111111010011110212122120200012221112a00122210010010111111111110111101101111111111101110111011111a111111111111101100111111101111101111110a11011111111101111110
010110001111101111022122112212010211112b12101011111100111111011101111110111111111010110111011100110a111110111111111111110111111111111011111a10111110110100110010
aaaaaaaaaaaaaaaaabaaabbbbaaabbaabbabbaaa12211211011111111101110111111101011011110111110111101111111a101111111111111111110111110111101111111a11110111111111101111
110111111110111101002122201211111122110220012210101111011011111111100011111110111111111010111111001a011111101101111111001111111111111110010a11111111011100111111
aaaaaaaaaaaaaaaaaabbabbbbbbabababbbaaaabbababbaaaaaaaaaaaaaa111011111011111111011111100111111111111a111111111111110011111011111111111111111a11111011111110111111
11001111001111101222121211120022002112110201211111110101111a001111111110111111111111011110111011111a111111101111101101001111110011111111110a11111011010110111111
11111111111111111212112211201022221000200022201100101101111a111111111010101011111111110011110111000a111111101111110101111100111111110111111a10111111111110110111
11011011111011011111111200201121122022122122201010111011011a111111111101011101110010101111111111010a100111011010110111111111111011111111111a10111111111111111111
11111101111111101212111222112120212020120100120100101111111a111101111011001001111111110101011111111a111111011111111111111110111111111111111a11010111110111110111
11111111111001011111111111111111110111110101101111111101111a111111111111101100101111111110111011111a111111111111110111101111111111111111111a01111011101111111001
11111111111001111111111001110111101100101111011111110111111a111111110111111111110111110101111111111a111001111011111110110111110111011111011a01010111101111111110
11111110111110111111101101111111111001110111110110001111111a110111101011111101011011101110111111111a111011111011111111111111100111101110111a11110111100111111111
01111111101111111111000111100111101111101111111101111011111a111101111111011110111111001111111111011a000111111111101111111011100011110110111a11011111110011011111
11011100011110101111111111111111111101110000110111111110001a001111011011101110111111011111110001111a111111111111111111110110101110001111111a11111111111111011101
11110111110101111111111010111111111111101110101001011100101a111110111111011011111111111011111111111a110110111100011001101111011111111110111a11011111111111111110
01011011111111011111111111111101011011111001110111011110111a110111111111010111111101111101101111111a111011000111111100111111100111010101111a11111111110111111111
11111111011001111111101111110110111111111111111111011111111a001111011010111111011110101110101110110a110111111011101111111011111011111110111a01111010010011101111
01111011111011111111111010011111101101110110111101110111111a101111111110100110110100111111111111110a111011111110111011011110011111111111111a11111111001111101111
10011111111111011110111101110111111111011110111111111101111a101111111101111110111011110010111011111a111110101111110111111111111001111111111a11101111111111101011
01111111111111011010111111101111111111111111111011001011001a001011101111101111111110101101111101111a111101011011111111111111011101010111110a11011111111111111111
11111111111111111111110111001111111110011111111101111111101a111111111111101111111101011111111100011a101101111011111111111001111101011101111a11111111011111111001
11111111101011011110111011010111001100010111111111111111011a111111011101111111010111110111111110101a111110111111111111111111110110111101111a00111111111111111110
11111111011111101111111111101111111111110111100010111111111a111101110100001111111111111111111101010aaaaaaaaaaaaaaaaaaaaaaaaaaaaaaaaaaaaaaaaa11111111100010010101
01101011111111001111001011101111111110111111111101111111111a1111111011110111101101111001010111111111101100011111011011101111101111110110111111101111011111110111
11100101111110011111111111111111111111111111111111110111111a1110111111111010110aaaaaaaaaaaaaaaaaaaaaaaaaaaaaaaaaaaaaaaaa1011011110111111111110111111111001011111
11101011111110111010101101101111101100111001111111111111111a1111011011111011011a101111111011011111111111011011101111111a1111111111110101111101111111010110111111
11111111001111011101111111011110111011111110111110111110111a0110011101111111101a111111111100011101111111111111111111110a0111010111111110111011111011000011111111
01011111111111000011111111111111111111101111111011100011111a0111011111111100101a100111111111111011101111011110111111011a0000111111111101111111111001111111001111
10111111101111111001100100001111111111111111111110111110101a1011011110111011101a111101110011111111111111111111111111111a1101111111111111111111101111111111111011
11111111101111011110111011111111110111011111110011011101111a0110111111111101110a111100011111111111111101111111110111111a0101101111110200111111222220011112022221
11001111111011111101111011111011101111101011111111001010111a1111011111111011101a111111011111101011110101101111001100111a0111110111220111021122222121222011112121
11111111111001111111111110111111111101010011111111110011111a0111010101011111011a111101010111111111111111111111111111111a1110111011012122111210120121210010122211
00111111111010111111111101110111101111011111101101111111111a1110010110101010001a001111111111111111001110110111011010110a1110111011010200101121211112111221222111
11111101111011111111111111111111111011110110111110101111101a0111111111111111111a101011111111110101101101111111001110111a1011101111211100220121101101120011111121
11011011111110101111011111110110111101011111111111011101110a0111011111011011110a101110011111110011111101010111111101111a1111111111111122122201021100122102221221
11011111011111111101111110111111110111111100111111111111111a1110011111110101111a100111011111111111011010111011111111111a1001111010220112222210102222121112111011
11111000011111110111011111101111101111111101110111111011111a1111111111111111110a110101101111101011011010101111111111101a0110101111202111011121001110122021122220
01000101101101111001111111011111111111101110110111001011010a1001101101011011101a111011111011111110011111111011110011111a1110110111222121122012020120112211022210
11111010101111011110011111001111111111011111111111111111111a1101111101111101111a111001101111111110111111100111110111111a1111111110010222221222102121121122202120
11111111011111111011110111111111111111111101111111111111111a1001111101011101101a111111111111101111011101111111111110111a1011110111222111121211110210200120022211
11111111111100011010111111110110111111110011011010100010111a1111111111101111111a111011111111011101011101001111111111011a1111111111101221210221222222022102101220
10011111111011010111102212102211011121210102121122021110111a1011001011010111011a111110111111111111111101111111110101101a1111111101201021122112001022102220211021
11100001101111100101012112121202120001201221100122221111101a1111111001111011111a101100011111111011111111001110111111111a1101111111220101120222111022102222111200
10111001011111101111110221222122012211112221021111111011111a1111111111111111011a111111111111111111101111001010111111111a1111111001111211112011220221111211220211
01100010110011110111111120211212222122112121010200211111111aaaaaaaaaaaaaaaaaaaaa111111110110011111111111011110111011111a0111111011222011211011122121201102002111
11010111110111010111111110111021112001102222202111101011111111111011111111111101111110001100011111111111010011101101111a1111110111112221011221110121011111210201
11111111111111111111112211221112221211200200202210020111011111111111101110111101111111111111101111111111110110111100111a0001001011100120210101002110122120121111
11101111011111100010111021020112222212212220212220121111011001111001001111111110111101111111111101110111111110011120212a2111112220202222112212211212121212221121
10111110111111111011111121002120011012201111222101111111110110110111111111111011111011011111111101010111111111012121012b0100201112222012022212112120101021222111
01111110111101111111110110000221212021020100111121221011011011011111111000111101111101110111101111111111001111101221200b0020221011220122221222122001201201202111
11111110111101010111112212110222101010101221202121220011111111111111111001101011111111110111111011110111101110111101211b1110120112012212211220221121221201122121
11011011111111111111110112222111212210102122202122221110100100201112102121221122221111011200100111111011100111111000112a1111112122222122020212112011212211102111
01111111011111010111111201112210212222202202220212111110110100221211221222111121212211011112111101011111101111112122200b2212112121222202220212220221111221212210
11111111111111101111011011111022222112112022210101010111111000221220201111121220220202211002101011011110111101112001101b1112202200022012210022101121202202221210
10101111111111111111112021220200112120102021111002211011101101202021212102222202112121211122111001110111111111112112222a1121221102211210202110220111001112102111
11010111111110101101111121121012122111111011012002111111111011221212212011221220222010111212011010111111111111111210221b0112222021201211212121111222111212110210
11111101110110111111111001211011021112211102021111001011111010222201211212122102200111200111000111110101111111112010211a1111012102222202122222222221222011111121
11110011100111110111112022221122122212112122212121221001111011211102221211120101122121022221111111011111110010110210010a2212222222111222222202222212101112120100
10110011111111001101112122122012121201112021111221101110001111111022210212020111212122222221111110011111111110011201202b0222222212122002122120202110211111111111
11111111111111111101112220122212101120012211121020121111111101110012111212020112221112221122011111101111111111012211210a1201111101121112222220111011111111111111
11001110111101111101012020112010122122000002112111010111011010220212001212112121101222211110111101111011101111111221221b2211122220222102121111111111100111111111
11011101111111011110111020222121222221211012112110221111011101112121122211211110001221120122101111101111011011102101000a1012022020011122102020011111111111011111
11101110111111100011111120222111201101222110122012021111100111211021221220111210220112221012101110111011001110111221020b2210111211001201110022111011111111111111
10111101110000111101012202101200222011211100221001221111111111122012121011201121110211221022011110110011010100111000120a0012101201212220022212111001111101111111
11111101111111001011100111120021010220121200112111121011111011120222002121112010011210202212110111110100111010111121222b2011100101001212111211101010110110111011
11111111001011011110111112221022120111121222102101110111111111211220120011211221122120221100111001111111011111112212211b1120011012001021020011110111111011111011
11111101111111101111112221121020220220222101201110021111111000012202121121221222210200021111111111111101111111111212100b0112210112222201221110001011110110111111
01111011111111111110110221221021100222210002111221121111111111212220211010211211212011021012101001111111101110111112210b0211120222111010222210111111111110111110
11011111111101001111112220100121120222221211201020201111101111110112022111120102010111221022111111101111011111112121021b2001211221220110210210110110111101101101
11111110100101111011112121211201212010212120221122021111111011020010112222211022221021220121111010001111111111011012111b1012112121111121111022101101110111111011
01111011111111111101112110201121022001121222111112121101101111021212110111121110221221102120111111111100101111010021221b1121120012112012212110011011101101111111
aaaaaaaaaaaaaaaaaaaaaaaaaaaaaaaaaaaaaaaaaaaaaaaaaaaaaaaaaaaaaaaaaaabaaaaaaabaaaabbbabbabbabaaaaaaaaa1111110111112112022b1122211210222222102222111111100110111011
101011111111111010111111011100111110101111001101111111111011101122122211121211121122021120201111101a1111111111110122122a2110221111100010221000111111111111011001
111111111110111111111101110111011011111111010111111111111110112211220220102221120211220220101111011a1111111111112221212a1201112002112112221021011101011111010101
101111111111101001111111111111011101111111100101010111111101110221222011110111121011220222111110111a1111110110112010112b2112122221112210121212111111111001110111
111111111101010101111001111011111111110111111101111111011011112102022111122102111201012222221111001a1111011101111122012b0112210011110111022102110111111111101010
111011111011011111001110011010011101001101101111111101110001110111110111121210121112122120120110101a1011111111010201222b2021211102112122122021111111100001111111
011111111111011111111111111111111110101111011111011110111101011110221221111122012122211001211111101a1011101111111111011a1111101010001001011111101001011111111111
111110011110111001111110111111111111010111110111111111111111001121202220121022121112222210210111111a1110011010101111111a1111101111110111111001111011010111010001
101111111001111011111111110111110110111111111111011111011110100211011210021221201012122210121101101a1110111111111111111a0101100110110100111010111011111011101001
011011111111111111111111111111001111111111111100011011111000112100111101202221122222021101221111011a1110011111010100110a0111101110111111111011011110111111111001
111001001110010111111011111111111111111010111101110011011111111110101011111011111111101100110001111a1011110111011101110a1111111111111111101101000111010110111001
111111111101111111101111011111111111111111101101111100011101001111111111111011111101111101111001011a1011111111111101011a1111001111111111011111111101111011111101
111011001101110111110110111110111101111111101111111111111110011110111001110111111111111101110101111a1101111111011111111a1110111110101111111011011101111111111111
111111010010101011111111111111011111111100111111111111011111110100011110111011010010111111111111110a1100111111101110011aaaaaaaaaaaaaaaaaaaaaaaaaaaaaaaaaaaaaaaaa
111111110011111111111111111111111111001110111110111111110111011111111111111111111111111111111111111a011001111101111101111111111111111110111111011111111110111111
111111111111111111011101111111100011111111111111111101111110111111111011111111111111111101111011111a011001110110111110110111111111111111111101111110100101101001
111011111101111100111111111110100111111111110011111111001111111110111111111111101101000100111110111a111111101011111111111111011111100111111111101011111111011111
111111010110011011110011111101111111110101011111111100111111110010111101111011110100111111101110111a101111001100011111110111111011110100111111111110101011101111
111111111111111011011011111101111111011110101101110100111111110111111011111111111111111111111111101a100011110101011110011111111111111011110011111101110001111001
111101110111010111111110110001110111101101111111111111111101111111111011101111111110111110111101101a111111011101110111110111110111111111101111111110111111111110
100111110111100111001110111110101111111110111001011111101001111010011111101001111111101110011111001a111111001101110101101111111111101101011111101111110110111111
