  
3 16
47 150
52 19
54 153
43 2
114 159
73 5
47 151
24 8
26 150
61 12
10 158
4 15
1 148
31 3
65 159
30 12
86 146
80 12
48 142
93 156
75 152
37 138
45 46
45 74
106 94
35 54
48 4
111111111111110111111111111111101011111a0011111111111111101101111111100100111011110111111111110111111011110111111111111a1111111111111011011011100011111110111101
101101011011111111111101001111110111111a1011011111101011111111111111011111111111100111111111101011111111111101111110001a1111110111010111111110111011111001111111
110101111011111000110111001111110010111a0010111111101011111111111110001111111111111111111111111110100111111101011011111a1111011111110111110110011110110111111101
111111111111011110111111111111111111011a0111111111111101101001011100111011110011111100111111111111100000011111111111111a1000011000011011111111110010101110011110
111101110011110111111110111111111011110a0100111111111100101101110111011111111110001110101100011110111110111111111111110a1111111111111111111100100101010111111011
101111111011111111111110001110111011111a1011011111010111111101011101111011011100111111111110001111110110101111111101111a1110110110101000111111110111101100101111
111111011011111111111100011111111101011a1101110110111111110010110111110111101111101111111101110101101100111111111110011a1111111101111111101101110011111011011101
111101011111111011001110110111111011111a1111101111100111110101111111111101111111110111111110011111011111111110011010111a1110111111100111110111000101011101111100
011111111111111111111100001101101111111a1111111111111111111111111010110111110100110111110101101111111111111111111111111a1111101101110111110111111111101110111011
111101011111101111101110111111111111111a1011110110011100111111111111110011111111111011111111010111011100011111110111111a1110111111111101000110111111110101110001
111111011111111011100101101111111101011a1100111111011111011011111111011111111111101111010101011010111111111101101111110a1111111100011110111111111101111111111111
011111101111110011110111011111110111111a0111101101111111111111111010111110110111111110111011111111011110111111011110011a1111110111111110111001110101111111111111
111110111111011110111111011110101111111a0101011111110011111101101111110111111111111101111011111011110111011111110111111a1011111011111111111011111011111101110111
111111101111010101111111110111111011111a1011101111111101101001110011110111111111111110001111101111110001000101110111001a1111111111111111111111101011001111011111
111111111100111101001111111001111100111a1011111111111111110111011111110011011110101110101111011111111011011111111101010a1101110111011011111111111100101111101111
100111100111111111110111111111111111110a1011111111111101111111111111110111011111101111110111011001111011111111110110111a1111101101011101011111111111111111011111
111100111111110111110100101111111010111a1101111111001010111111101110111000111101111101101110101111111110111111111011111a1111111010101001101111011111101111111111
010010101111011111110111100011101111101a1111111111101011111111101111111001101011101111111111111101111101111010110111010a0111011111111111111101101011011111101110
111111110111110111111111111111111111111a1111010111111111111111111111111111011101011110101111101101111011111111011111111a1011111111010111100011111010111111111101
111011011111111110111111111110011110100a1111010011111101101111111001011011111110011111011011111110111011111010101111011a1100111100111110111111011111111101101111
111111111111111111111111111111111111111b0011212112212111112221112210211100101111111110101101000110110101111011111111111a1111111111101101111101111101111111111010
011011101111111111101010111111111110001b1010211011021212112111221112111001111011011111101111111010111111111001010011111a1111111111011111111010111111111110101101
101111101110111111110111111011011001111a1012221121122102121211122221011111011011111111101011111111011111111111111111111a1102212200121202112122211002022221101001
111111011101111111110110111101111111111b2211112222222112002122211221211101110111111110011001111100110111010111111001001a1101101022000212222220202001222111111111
111111011111000101101111010101111111111a222121102100000221212212222121100111011aaaaaaaaaaaaaaaaaaaaaaaaaaaaaaaaaaaaaaaaa1112111210021212112100221111112201101101
010111101100111010111111111111111011111b222021201012022112022222101210110110011a11111101101111011110111111111111011111001110212022122111110001021220122211001110
111110111110110011111101111111111101111a201211222222121011101122222001001011011a11101111110111110111111101101110110111111111212122201221201002012212211021010011
110111010111110110111111101011111110111b212211021202222220210011112110111111101a11111111101011111111100111010101111011111011221221222220122212112121022021110110
010111011111111111111110111101111111011b022220221211211220122021021200110001010a11101110011111111110111101111111110001111112222212222221121101221021112120111101
010111101110111111110111111011110010111a012012111122111011112122222011111111011a11111111101111110101111111100111110110011002011121120220211222111222210211110111
111111101111111111011011111110111122122a221212122212202122212222022121022021122a12020211101111111101111011111111110011111112002120012121212211112212112211111011
111111111111011101111111001110121122022a120220222221221212202221222102121221210a22101022210111110111111011111111111011010001022020221122220120201121201011111111
111111110101111010111111111111121220111b210122110202012020022021202212121202220b11111121111110110101110111111101110101101010222221112120211021201211112101111111
211021122222222212211101111111112222111b021021200201211122222210102202201010022b12211110111010010110111110011101111111110100022120222201122201201111222101111011
110112020110121112111111111111101101102b220202021112202221122121220221001012111b20011111111111111111110111101111011111011112010122011221120221120222120020111101
122212212222221121211111111111112121212b222120012202222000222222102100221120212a10120121211101011111100101110111000110110100121210110221212201011202111121111001
102212211122110222011111101111012112221b222222222122010200120202212022222121002a12110101011111111101111111111111111110111111121202111211121012201112112011111110
222212221221111010210111010111121111111b202012211220122120002011212221122101101b21212202011111011101111111011111011111111112221221111212202021122121221221111111
122021112202222120001111110111121010110b121122210202211220200222120201210210110a21211111001111111110111011001111101111111011012222010121121101202122101121111111
220221012100111112211110111011122221111b022022111222211102021220222221221201002a12221200101111111111110111111111011101011111222221112122121222212222121210111111
101112212112222202011111111111021121211a221202100012210220120222222011211202221a10210212111001111111010111111111110110111111221202112202122022200222020111111111
221012102112011222211110111111120121201a210222120222200211222012122122022112212b12221102211110111011011111111111101011111110211222102112222122211211101220101110
221222211221111112210100101000021112210a222101212122222222022222000022112022122b11210102111111111111011111110011110111111001111202221211011212120101012010100110
111221021102212221011000011111121012212b122200012201220020222212212220221112220a01111201111111100111111010001111101101111011001111111210121221100201210121111111
011221110021210220211110111101112011210b001111222002212222222101001222111222212abaaabbbaaaaaaaaaaaaa111111111111111011110112222221121111111021210122211021111111
212220210201111012200001001111112000222a12222110121212022221210211222210021220211211110211111001101a111111010000111111111111122221221221222221120121022111111011
111201212200102111010011101001120201022b20222022220212012202212202222121210022011222212110111111011a111001011111011111011101102202112122021112222211210121111111
002211111222112202111111111001121000210b22222222221122222222102222110002020200201112112121110111011a111111111111111111111110100122022121110122121122122121110111
010202021121121012111111101111102111201b21022022222002221222122022220212111111122100222220101111011a011111101111111111001111010212001022201011101021221101101111
201222212111211112211111010111122022122a02202221210202101222201122202112211202202201211211111101111a011010101111101111101111121101200212221012121111221111001111
211221112111201110111111001111111212012a21001202222122102201212212222222112121122021022221111110111a111111101111111111111111112220212021021212121222120201101110
001011221101111120211110110101111121020a22111011002100221112211011111220201002211210211221100100111a101110111011011111010112020122212200212221010111111210111101
101021011122120222211110111100102122111b20110112211102111112222212222012121212220020021120010001111a111111111011111111111111111101111111111111111100111011111010
111222101102112021110111011111112012210b21122000102220011112222222222011222121012220222211111000101a001011111111101111011110111011111111110111110001111111101111
202210112212222022111110111111111010102a10121201201102022122022101212020011021122122211220101111110a011111111101101111111111110101011111101111111110011111111111
021110021201112211010011001110122121201b20121222121111001111211221122110121210020122221221101111111a110110101110111101100111111100111101111111110011111111111111
011110121112211021211111111111111121011a20121111211212021111211211122200112012122211021011111111111a111111100111111111011101111111100111111111111111111101100101
110211121012220002201111111101122211020a22120021021112220012122000101210221200122101022010110111110a111111111011011111110101111111011011010111111011111110111101
100210210211111121010101111111121122210b20201111002111112020211202211110020110102210002221111111011a110111111111111111111011111111010110111111110110011111111011
200212222112110221101111111011121212111a21121211211211211121122202212012222210121110101101111001001a011111111111111111101111110111111111101111111111101110111111
110210110212020221210111111011111111111a01011111111011111111111101111111111111110010011111110111111a111110001111101110110111111011100111110222212120112121200101
110110112210220100211111011100111111110a10101101111101011111111011111111111111011111111111110011111a000101111111110111101110111111011111111112022202022201202021
212121101021021101001011010111110111111a10111111010111111011101011111101011111111111110100111011111a101111111111111111111110111111110111002212221021102222211121
110101111111110101011110011111101110101a11110011011011101111111111111101111111111101111101110111111a110110111110111111011111111111111101121121011222020101221121
111011101111111111100011111111111111110a11111111100111111111100111111111111011111101101101011110111a101111011111110111111111001011111111102211111120112212000201
111111000101110011111111101111111111101a11111111111111110010101111111111111111101111110011110111110a110111110111111110110110111111110011022021221212021111210221
111111111101111101101110111101110000111a11111111111111111111110111110110011001111111111111111111111a111111011101111101111110111111100111021222222222000202102221
111111111111111111111111111011111111101a11111111111111110011111010110110110111110110011111111111011a111111101111001100000111101111110011111112021201212220222211
111111111111110111101100111111101111001a01111101001111101111011110111111111111111111011111110111100a111110111111011011011111111001111101121002202211011001201211
011111111011111101101011111111111011110a10011110111111111011101111111110100111111111111111111111101a110100111111001111101111110111111110122102122121121102001121
101110111111111111111111100111111101111a11111111111111101111111101010011101111111011111111101111101a111110111111111111110111111111110111121111211112112221211121
011010110111111111110111111111111111111a11111011001111111100111011101110111011001111101010111111101a111011101111110111111111100110111111102112202110121120222110
111111101110011111011101111101011110111a11111110111111111111111111011111111111011011110001011111111a111111101110111111111101111111111111121010020102221021220211
111001111111110111100111111101101111110a01010111110110101111011011101111111110110111111110111111111a110011111111011001110111110111101110122001122120112022211100
101111111111111111101111011101111011111a11110101111110111110011101111101111100011101111111011111010a110011111111111001010111111110111010120221021122002121201111
111011111011101111101111111101111001011a11101101101011101110001111111011111101001111110010111111100a111111111110101111011111111111011111110202211012020210020121
101111111011011011111111011101111110111a10000011111010111001101101111111011111000111111101101101111a110111001100111111101101110111111111112002221111212122122111
011111111011110111101110011111100101111a11111111111111111111111001111111101111111110111001111111111a111110111111101111111111010101111111121212022121120221111221
111111101111111011111111111111101101101a11111110101011101011101111111111011111111011111111101111111a111011101110011010111111111000110011010212011222202200222011
110011111110111101011101101111111001111a11101010110110101110011111110111111111111101111001111111111a111111011011111110111111111001011101122212212020212112202120
111111111011111110011111111111110011101a01001111111111110110111111111101001101111101110101011110111a110101111111100111111011111110110101012222222222101001222111
101111111111011111111011011110111111111a11111011011111101111111110111101111110111010111111100111101a011111100001101011111011111100100110001120012021222022222021
101110111101011111110110110101011111011a11111011101110111111110111101111111011111011111111111101011a111111011111111111100111111111011111022112222222221202202201
011110111111111111111110111111011111111a11101111111111111011111111111111111001110000101111111111111a011001111111111111011111010111111111110102221221222022222101
011011011011111111111111111111111111100a11111011110011111111100010111111110111100111111100101101111a111110110111011100111111111111111011000202022102221222002221
011111101101111111111011111100100011011a11110110000111101110110111111111111111011111111001101110111a101110111111111110101101101111111111022110201021222212122211
111101111111111101111111111101110000011a11101100111111011111111011111100111111111111011111001110111a111110111111111111111001111111101010011002221222220022220111
011111011111111011111110111110111111101a11101111111111110000011101111111111111011110111111110100110a101111100100111011111111111110111011020112202210120122111221
111111111111111111111010111111111111111a11110111011111111011110111111011001111111111111011101011110a100111111111111111111011101111011111120110102222022122012221
111011011111110111101111101111111111011a11111111111111111111111111011010111111111111110111111100010a011011110110111111111111111111111111121122021212212210221111
111111111010011111101111101011010000101a11101111011011011111011000001011111111101111111111110111111a111111110010111111110111101101111111101112022211021211221020
111111010111110101111111111101110111111a10111111111101101111001011101011111100120122221212112110122a121121121101010111110111101110111111110111222122102000221001
111111111011111110111111101111101111110a11101101110110111111111000110001101111110011211111212111121a111112120011110111011011011111010000111010221102210111120211
011111110110011111111111111111101101111a01111011110110101011111110111101110111122112102012112221011a120221220110111111111111101001110111110112211111100120111011
111101111110111101111010111111111111011a01111001110111111111111101011111101111021211211112010122002b110222122111111110111111110111111111101112000211112011221201
111011001111111011110110111111111111101a01011011101111010111110011101011110101122111210122111011102a111101201101110111111111110110111111110111202221101001120211
001111010101111111111111111011111011111a11001111101101111110111101110111111011101222222122100102211a112212000101111110011010111110111101111112121121110012212211
111111111111111111101001011111111101101a11111111111111111110111001111101000011100010122110122122200a222221111010110001111011111111111111111012221212111201121111
111011111011111111010101001111111011111a11111011111111110011101111111111111111022110211220220211222b222100111111111111010110011111001111001012101110122212001221
111111110011111010111001111011111111110a11101111111110110011010110111111111111100212210220111220120b121122222110001101110111111111001110101111122012211112121011
aaaaaaaaaaaaaaaaaaaaaaaaaaaaaaaaaaaaaaaa10111111111111111111111101101111110011021112222000112212211a012101120000010111100111101111010101010112021211120212222101
111111110111111111011011100111100111111101011111011111011111111101011110111111122221021021112110022b210221102111101111111111111111111101111112201222221112121111
011101111111111011111111111000111111111011111101111110111011101101001111111101122100112022111002121a221221021100111111001101111111111110011111022220101201221021
111111101111111011110001111111111111111111110111111010100101111110011110101111110222111211021221201b212112211111110111001111111111111111111102102111100200121221
aaaaaaaaaaaaaaaaaaaaaaaaaaaaaaaaaaaaaaaaaaaaaaaaaaaaaaaaaaaaaaaaaaaaaaaaaaaaaaaabbbabaabababbabbabaa121122001111110111111111011111111111111111101211221011212100
1111111111111111011101110111010110010111110101011111111011011111010000111111101212221102100122111121020210221010111111111111111011111111011110221211120202121221
1110011110111111101111110011111011110110010111011011101110111111111111111111011111000022221121211120222022121110111111111110011101111110101110121112202212212221
1111101100111110011110101111111111110111111111111001011011111111101111111101110221211222122101122101222210120101111101011000111100111111111112212012122211221020
aaaaaaaaaaaaaaaaaaaaaaaaaaaaaaaaaaaaaaaaaaaaaaaaaaaaaaaaaaaaaaaaaaaaaaaaaaaaaaaaabbbbbaaaaaabababbbababbbbbbaaaaaaaaaaaaaaaaaaaaaaaaaaaaaaaaaaaaaaaaaaaaaaaaaaaa
1110101011110011111101111110111100101111101111101111111110111111111111111111111221102201221211010221222111201111111111111111101111111111100111111110110111011111
aaaaaaaaaaaaaaaaaaaaaaaaaaaaaaaaaaaaaaaaaaaaaaaaaaaaaaaaaaaaaaaaaaaaaaaaaaaaaaababaabbbbbaaabbabaaababbbbaabbaaaaaaaaaaaaaaaaaaaaaaaaaaaaaaaaaaaaaaaaaaaaaaaaaaa
1111111011111111111010111110111011111110111111101101111111111111110111010110111012211112220122011222021112210111111111111111111111111110111110111111111111111111
0101110011111111111101111111011101011101011101011111110001001100111111101001100222022122110210212112220012212111111110111011101101111101111111110101101110101110
1111011101110101111111011111011111111111111111111111101110111101111110111101111122112112021021100221111212002101111111110111111111111111111110111101011111011101
1111111101101110011100110101101011101111111111111111101011101011111110110111101002220120112122022021111200020111111101110111111001111110101111011111001111111111
1011011111101111101011011011110111100110111111111101111010101101111101101111111122022102221211120112020111211111011110111111010001011111111111111101110101111111
1111111011110011110111111111111110010111111101111110110111111010110101011111111122122221120101122000121121202111111111100011011110111101111111111111111110111111
1111111111110111011111111101111101111111111111111011111110110011111001101111101012111022101121112012202012221111101111011111101111111110110111111100110111010110
1111111111111100110111110111111111111111111110111110111111111110101111111010111101111211020200112221011102201111011111101111111111011111111110111111111111110110
0011110101111111111111110111011111011011111111100011111110110111100011111111111111111110110011011110111111110111111110110101111101111011110110101111010111111011
