  
45 19
107 157
77 16
108 148
71 14
46 154
47 1
11 153
102 4
49 156
66 16
113 157
87 5
77 146
87 5
117 142
112 8
92 147
20 19
76 151
93 156
75 152
37 138
45 46
45 74
106 94
35 54
4 4
2211201122220220012111111111111111111111111111101110001111111111101111111011111110011101110110011011001111111011111111101111110111111111011110101111111111111111
2100112001111121112111011111111111111110111101101111111011111111111111111010111110011111111111010011101111101111110101101111111111110011101011101110011111111111
1122210212222021121010111110111111001111111111111001010110111111111111111011111111011111101111111100111011111111101111110111111101101100111111011111111111111111
2000212201020110220111111110111111111111111111111111100100111110111101111101111100101111111110110111111110111011110111111011111011111101111111011111111011010111
1222212221221111110111110101010111101111111111111101111111101111111101101111111011011111111111111111011111011111011011111101100111011111111101011100010101111111
2122201010022222102101111101101101101111110111111011011111101011011111111101101111111101101011111111011111111010111011101111111111011111111111011110110111110111
0022021212122101012111111111011111010111011110101101111111110111111011111111110111111111100000011111111111101111111110011111101111110111011111111011111111101111
2121012212112222022111111111011011100011111101111011111110111110111111111110111101101111111011111110101110111111011101101100110010101111111111111111111111110111
1221102122012211222011111111110101011110111011011111010011111010111011111111111111111111111111111011001111111101111011110101111111110110111111111111011100111110
2221202211200111110101111011101111110111110001111101111101111101111001101011110101110111110111111101110111111111100111111011011101110100011111111111111101100101
2011201121112002201010101111111110111110110101111111010011111111111111101111111111001111111111111111111110111111011100111111111111011010101111111110011111111100
1211201110121210222111110111011111111111111110111101111111110110111111111111011011100001110111101111110111110111101011111111111111111111110101111111110111111111
2212022210221111112110110111101111000110011111110111111111111111111110111010111011111111111111111111000110011011111111111111010001101111111011111111111111111110
2111211210011112101110011110111111110111110101111111111101011010110011110111111111111101101011110011111111110011011010110111111001011111111111111111111111001111
1212210010222112200110110110111110111111011111111110111111111111111111111111101111011101111000010111111011111111110100111111111010011111110101111111111101001101
1200202021121021100111101101110111111111001110111101110011111111110111111110110101011111011011010111111011111111111111111111011011101110100111101011111101110111
1201022202111211012111111111111001111111110101011100101110111100101111111111101111110101111101111111111111101111111111110010111111101111101111111111111111111101
0011021012111220110111111110110111111111111111011011010111101111011111111111101111111111110101011101010111111111100110111111110111111100111111111011111111001111
1210100221121101121111111010111111110011101101100110111111011011111111101111111111110100011101101110111111101111111111001111110111101111011011110111111111101110
1111011111111101110011111100011111111110111101000111111111101110101000110011111111110110111111111110111110111111111101011111101101111111111111111101111011011110
1111110111110111111110011101011101011110111121211201010011222111021220111111111010011110011111111011111111111011111111010011111111111011011111111010001111011111
1111010110110111111110111011111001111110020021101112121211211122111211101111111111111111110111111011011111111111011111011110111111111111111111111111101110001111
aaaaaaaaaaaaaaaaaaaaaaaaaaaaaaaaaaaaaaaaababbbaabaabbabbababaaabbbbaaaaaaaaaaaaaaaaaaaaaaaaaaaaaaaaaaaaaaaaaaaaaaaaaaaaaaaabbabbaaababbbaababbbaaaababbbbaaaaaaa
1110110111101011101111111101110111111112000010022222211211212220122121111011111110111111110111011111111111011101010111111001001022020002022022012001022111110111
aaaaaaaaaaaaaaaaaaaaaaaaaaaaaaaaaaaaaaaabbbabaaababbbbbbbababbabbbbabaaaaaaaaaaaaaaaaaaaaaaaaaaaaaaaaaaaaaaaaaaaaaaaaaaaaaabaaabababababaabaabbbaaaaaabbaaaaaaaa
1101101111111111111101111110011100111112002121211212002012222202121211011100101111111110111110101010110011111111011101111101212022120111010011001202122011111111
1011111110011111111111111011101111110111011210222222121210111122222021100111101110110111111111111010100111111011101111111110210122011021221212110212011121011111
0111111111111111101111110011111101111112212201021222022021212201012111111011111111011111110101111111111110111111111111011110201221222220122212112021222101101111
aaaaaaaaaaaaaaaaaaaaaaaaaaaaaaaaaaaaaaabbbbbbbbbabaabaabbaabbabaababaaaaaaaaaaaaaaaaaaaaaaaaaaaaaaaaaaaaaaaaaaaaaaaaaaaaaaabbbbbabbbbbbaabaaaabbaabaaababaaaaaaa
1101111111111001111110110111101111111111202112111102001111112020222100111110111111011101011011110111111011100111011111111102201121021222211222111220210011101101
0111111101110111011111110010111111221221220212102212220120010222020121222121122112021211111011010111110111111111101111111112112122112121212211110212012210011111
1101011110101111001111111111111211222221122220222221220212222221202022120201212122111202011111011000111111110111100010110111220201221020222120221121221210100110
1111111111111011111111111111111212211112212102112222212221222201222212020202020201011121111101111111011111010111111110111110222020012120211021021211110101111011
1111011111111110110001011111011122220112101220222201001122002212000202201211222202211011010110011011101111111110111110011111122021222211022221011001222111110010
1101111111111110101111101111111111110222202222121102222221122120220220021102011000111111111111011101100111111111111011110112112102011201102221121220000220111011
aaaaaaaaaaaaaaaaaaaaaaaaaaaaaaaababababbbbbabbaabbbbbbbbbbbbbbbbabbabbbbaabbbabaababaababaaaaaaaaaaa111000111110011100111110121211102201212211211222111121011111
111110110111110100111001111111110112221222220002212201222012222221222202202110211211101121111010011a111010111111010111101111121020110211020112201102112101111101
111110111111011111111011111111120111011221221221122212202112001121222102212112102120222211111110101a111111111100101101011112221021101210212121002101221221111111
011111110001111010110101101111121011110212112201221201020202100010122021221211012021110121111111101a111111111111110111111111112002112121121101202120121020111111
101111111111101101101001111011122221101222222211122221112022120222022122022110211022100111011111111a111101011111110110111111222221110122121222212222021201111111
111110111111111110101111111110101121211122120010021221220212022222220001102022111221021010111101111a111111101110111111110111221210112012122222012022022111001011
010111111110111111101001111011121121221121222012222022220120221212212222211021221002100021001011011a011111111111101111101012011222122002200102211211121021010111
101101111111101111110011110111101112210122212121012222222202202020112211210212021120212201111111111a001101111101010010011111111220201211111212122121012201111111
111011110111111110110011010101121012212210201121221122222122220221222122011222112000120111111111111a110011111011111001111111111110111211121201100221202121101101
111010111111111011101111111111112211212222101122022220222020202122022211122201212110222100111011111a111111111101111110111112202221121111111121012100211121111111
001110010111111111111111111100102211220110222110121012122201212211202212201221200211101210111111111a111110111111111011101011122021221221222221121121222111111100
111011111100011111010111011111120221222200222002222212210200202012222121011222111222202101111111111a111111111111111010111101110212102122021112202210211121111100
111101111111101111111101111011101021001220222222221102022222122222112210102021211012112121111110111a111111111111111100110110111122120121112122121122122020111111
011110111111111111110111111011122101211221122222222222221222122222221212110110122112222200111111111a110011111110111011111111110012121220201100120021201121011111
110111101111111111111101111111122202122112002220212002111002221122210110211202012220211011011111111a111001101111111111101111021110211212220112121001221101111111
011011111000011111111111111111110202110121221212200102112201212210222002112120120000222221011111110a110111101111111111110110012222200220021202100222121221110101
111111111111111111011101111111111121121122101111212122221112010211111222211112210212001201011111111a111100111111101111011012001102202011212221100110111211111011
111110111111111110010111011111102022101022101112211102111110220202222012121012020001221121010111111a011111111111011101111101111111111110101111111111011011111101
101101111111111111001101111101002212211221122101102001111112022022222211222121112221002210111111111a110011111101101011111101110111101110111111110111111101111111
111110101111111111110111101111111100112112120201221112122102022120210102211101102122211221111011100a111101111111110010111111001111001111101101101111111111010111
010011011111111010110101111111122121211221121020120011111110211201020112121212200120021201111011111a011111111011111101111101111111111111101001011111010101111110
001011101111111100111111111111100001111122101111210212221111201211120210112112122211001201111101111a111001111011111011011111001101111011110001101111111111111110
111001101110111111110111101111120211121022121200121110222202122211110210220202122121202210100110101a101111110111111111011101111111111001111111111111011110101110
001111111111111111101011111111120020212021211111220111112120201222011112021111122211122221110011111a111011110111100101110110101111111111111111001011111111111111
101011111111001111101111101110121212101121121211211211201121022012212212222211101111020111111011011a111111101111011011111111110111110111111111111100111111111111
111011111001111111101111111111101111111111101111111110111111101000110101111111100111111111101100111a111101111101111011111110101100110111112200212122112100211111
111111001111011011101111111101101101101110011111111111111100011110111111111011101110111111111111111a111111111111111111100111110011111111111112002022120210202021
011111111111011001101111111111111111011110011111111011110111111111111111111111111111101111011011110a111111011111111111111111111111110111112212021221022020211121
110110011111111111101111111111111100010011011111111111110111001111001011011110101111101111110111111a111110110111011010111101111011111101121121111200220111201020
101011101111011111110011111110111111111111110111110101111001001110010111000100111111111101110111101a011111111111111011111110111111110111110211111122110202102201
111100001110111111111111011111111000111011001111011111111111101011111111110111111110101101110110110a111011111010111110111111111111111010022121221212121111212221
101011111111111111011101111111011111010101011111111011111001111111111111111100011101111111111111111a111111011111110111111001111111011101020222202202121212112021
101111111011010110111111111111111110011011101111111010111111111011111011111111000111011111111111111a101111110111111111101011011111111001111102220211212201222201
101111100111101110011110110110010011111111111110101000111111111111111111111101110111011010111001011a100111111110110111100011111110111111121122210011101201200201
100001111111111110110100111110111101111100110101111111101111100011111111011111110101111101111111111a111111111111111101100111111111101111120122122101121122010121
110111111111011111111111111111011111111010111110011111101110011100111010111111111111111110111111101a111111101101111111011111010111011001120111011112102221011121
011110101111101111011001111111111111110111111111111111011000101001111111111111111110111111111001111a111111011011111111111111011110110111112102222110121020200111
111101110111111111110111101101101110111111111111011111010111111110111011101111100111101111101110011a111101100101111111111110001101111111100211222022221021202211
111111010101111101111011110011111111111111111111011011011111111011111100110111111111110111111010111a111111001110101101111111101011011111120121002121112120211101
111111101100111101011111111110101111110111001010110111000111111010111111111111011100111110111111101a111111111011110101111111011111011011122021021102222121201111
101110111011111111111111111111111101011110010101111111111111111011111010111111101111011101011010101a110111110111101111011010100111100110102202211212020210020021
111111111010101111110110101111111001111101111001110111101111111111001101111111011110111111111101111a111111011101111001101011111110111101112202221011012122120011
111010011111111110110110110111111011101111111111111011110111111101111111111101111111110111101111101a111101111111111010111101111011011111101210022121121021010220
011001110111111100111111001010110111111111111111111111111011111111110011111111111101101111111111101a111101011011011111101010111111011110112212111222202020222011
011111001110101111111110111111111010111010010111111110100111001100111111011011111111101011111111001a111111110001001110110110111111110111122212212021212112020121
111111000101011101111111111101111111111111011000101111001110110110111111110111110111011111111100111a111101111011110111000101101011110110112222222222121201022011
111111111111110011111111111011111111111111111110101111101111011011111011111111010110110111111111011a111100110011111111110111011011111111111000010021222222222121
010111111011111011011111111101110111111011111011101111011111111111111111101110011111111111101111111a001111111110111111010110111111111111122112002022221220220221
111011101111111111111101011111111011110111111111111111111111110111111011011110111011110101111111001a111001111111001110101111111111111111101100221221220002222121
111111110110111111111110101111101110111010110110111111011110111110110111111010111101111111111100111a111111111010101111011111001111011111100212220102220222220221
101001111111111111111111101111010111111100111111111110111111111111011111111111111111011111111111011a111111111111011101111111111111111111122012221121202202022211
111101111110010111111010111111110111111111110111011111110110111111111111111111111111010110111111100a110111010111111011111110111101110111111212221202200202220101
101101110111101111111111111011111111110111110101111110110101111010011111111111111111110011101110111a101011111111011111111111111111101111122112222210120102011221
011111111111111110111111111011010110111111011011110111111101111110010010100111110111001011111001010a110111111101110111101111010111110111100102122222120022212221
011111111111110110111111011111100111111110010111011111010101111111110111011100011111110110111100110a111110101111011111111111101110110110121122200202212210221111
101111111010111100010111111101101111110111110011011001111110010111101111111011111111111011111111111a111101111110111111110110110101110111110102120201221211200121
111011111110100111001010111111111101111011111110111111111001111111100111111111120122220212112012122a120021100111111111101111111111011111111101220122102201001221
001111010111011011101011011110101111111111111111111101111111011111001111101011102111211111212110101a111102122101111111011001111101101111111110201102202011121211
111111111111111101111111111111111011111011011111111111111111111111101111011011122112112112110221101a121221221111111111111011101110111101011112211110111121111201
111111111111101111111010111011111111111101011111100100111101111101010101111011121211211112110122122b102222002111011111111110110111101101111012201011112211221220
011001101110111001111110111111111011111111111111101111111111111011111111111011122111212122011210112a101121211111011111011111110100011111100110222221101111121211
101101111111111100101011101111101110010111111111111111111010111111111011110111111222202120112112211a002010221011101111111111111111101101111010121020112212210200
011111011110111001111111110111100110111011111111100011110111110101101110111101122110020112022022201a202220111011111101011111011011101111111102221212111220121111
111001101111100111111111011111111110111110110110111111111111111111111111110111022111200221022210222b022012111111111111111110110111111101011110010101122010121201
101111111111011001111111111101101100110011011001111011111111111111011111000101110210212001011222122b100122202111011110011111100111111110010111122002011112120101
111011111111100111010101101100010111111111110111110010111101111111001111111101121012222001112002201a210120102110011111001001111101101111111112120201121212222121
101011111010111011101110111110111110101111111111101111010101111111111111011011022221220100102111222b211200112010011111111110010011011111101102211222221112121111
101111011010010111011111101111101111111110111111111111001101111111110111110101122101102222111022121a221221221101010011111101111100011111110111102022110211221220
111001011111111111111111110111111111011111110101111011111111011101111111011111111222110211121220221b212112011111101111111110001111110111110110122000121222020220
111111101110110110011011111111111011111110111001111111111011101111111110011111112221011012122120121a101022201011111111111110111110011000111011111201221110010121
111111111111101111011111111111111111110111101111111110110010011111111111101111121220110211212210112a222210021111111111100111101111111111111111021211122212020221
101101111000111011101111111011011011111111111110111111111011111111101111111011111101222020112121012b202222121111111111110110010111110001111001121112222210212201
111101111110111101011101110111111101111111111111011010101011111111110011110100002120100212012112212a222211021011111110001111010100101011111112212012020211021100
011111011111110111101111110111110110111111101011011101111111110101101111110011111200220111112001222a202220220111101111011111110010111111011111101111101101111111
111101111111110010011111110111111111111111111011111111111011111010111111111011122112221120121111122a022111221111101111011101111011111111111111111111111101111101
111100111111111010111100111111111111100111101110011111010101001111110101111111101211222001102202011b122020120010110111111011111111111111111111101111111111110011
111111011101011111111110111111010110111111111111011111111111110111101111111011021201011202212010122b201112212010111101111111111111110110111011111111101111110001
011101111011111111111111011111010101111001111101011110111111110111110110010111120210202211221121211b201012212011111111111110111111110111110111010100111110111111
101110101100111111111110111101111110111101101101111111111011011111111111101111102200001222012110002a110212212110111110111111101111111111111101111111110110111111
111010101100101101111011111111011111111111011111111101111111110111111111110111112222112210212012222a111212122111111111111111100111111101011111111111111111101111
111111111111101111100011101110111001110111111110111101111111111110110011111111012212211222121112011b221010211111110111101111111111011111111111111101111101101111
111010111011110101111101110111111011101111011110101011011011111111110010110111112212222112112112210a121120220111111111111101111111001011111110111111111111111111
111111111110110111111011101010100111001110111110111111111011110110111111101110110011022211012011221b222210221011111111001101111111111001101111111111111111111111
111101111000111101111101101101111010011011111011101110111111001111011111101111112111101012222211222a211002221001101110111001010110101010101111110110111001111111
101111001111110111111111011111111111111001111110111111101111101111011111111111011111111111110111111a011111111111101110111111101010111111110111110111011111101111
